11111111111111111111111111111111111111111111111111
11111111111111111111111111111111111111111111111111
11111111111111111111111111111111111111111111111111
11111111111111111111111111111111111111111111111111
11111111111111111111111111111111111111111111111111
11111111111111111111111004111111111441111111111111
11111111441144111111111111411111111111111111111111
11111111111111111110011111141111000111441144111111
21111111111111111111111111114444411111111111111113
00000000110000001100000110000000001100001100000000